asm => asm
auto => auto
bool => bool
break => descanso
case => caso
catch => captura
char => carbonizarse
class => clase
const => const
continue => seguir
default => defecto
delete => eliminar
double => doble
dynamic_cast => dynamic_cast
else => más
enum => enumeración
explicit => explícito
export => exportar
extern => externo
false  => falso
float => flotador
for => para
friend => amigo
if => quando
inline => enlínea
int => entero
long => largo
main => principal
mutable => mudable
namespace => espaciodenombres
new => nuevo
operator => operador
private => privado
protected => protegido
public => público
register => registrarse
return => regreso
short => corto
signed => firmado
sizeof => tamañode
static => estático
struct => struct
switch => cambiar
template => modelo
this => esta
throw => lanzar
true  => cierto
try => tratar
typedef => typedef
typename => escribeunnombre
union => unión
unsigned => nofirmado
using => utilizando
virtual => virtual
void => vacío
volatile => volátil
while => mientras
goto => vamos
#include => #incluir
