asm => एएसएम
auto => ऑटो
bool => bool
break => टूटना
case => मामला
catch => पकड़
char => चार
class => कक्षा
const => स्थिरांक
continue => जारीरखें
default => चूक
delete => हटाना
double => दोहरा
dynamic_cast => dynamic_cast
else => अन्य
enum => enum
explicit => मुखर
export => निर्यात
extern => निर्वासन
false  => असत्य
float => नाव
for => केलिये
friend => मित्र
goto => केलिएजाओ
if => अगर
inline => पंक्तिमें
int => पूर्णांक
long => लंबा
main => मुख्य
mutable => परिवर्तनशील
namespace => नामस्थान
new => नया
operator => ऑपरेटर
private => निजी
protected => संरक्षित
public => जनता
register => रजिस्टरकरें
return => वापसी
short => कम
signed => परहस्ताक्षरकिए
sizeof => इसआकारका
static => स्थिर
struct => struct
switch => स्विच
template => टेम्पलेट
this => इस
throw => फेंकना
true  => सच
try => प्रयत्न
typedef => typedef
typename => नामलिखो
union => संघ
unsigned => अहस्ताक्षरित
using => काउपयोगकरतेहुए
virtual => वास्तविक
void => शून्य
volatile => परिवर्तनशील
while => जबकि
#include => #शामिल
