asm => 汇编
auto => 汽车
bool => 布尔
break => 打破
case => 案件
catch => 抓住
char => 烧焦
class => 类
const => 常量
continue => 继续
default => 默认
delete => 删除
double => 双
dynamic_cast => 不变
else => 其他
enum => 枚举
explicit => 明确的
export => 出口
extern => 外部
false  => 假
float => 浮动
for => 对于
friend => 朋友
goto => 去
if => 如果
inline => 排队
int => 整数
long => 长
mutable => 易变的
main => 主要
namespace => 命名空间
new => 新
operator => 操作者
private => 私人的
protected => 保护
public => 上市
register => 寄存器
return => 返回
short => 短
signed => 签
sizeof => 大小
static => 静态的
struct => 结构
switch => 开关
template => 模板
this => 这个
throw => 扔
true  => 真正
try => 尝试
typedef => 类型定义
typename => 类型名
union => 联盟
unsigned => 无符号
using => 运用
virtual => 虚拟
void => 空虚
volatile => 挥发物
while => 而
#include => ＃包括
